11 11 11 11 11 11 11 11 11 11 11 11 11 11 11 11 11 11 11 11 11 11 11 11 11 11 11 11 11 11 11 11 11 11 11 11 11 11 11 11 11 11 11 11 11 11 11 11 11 11
11 11 11 11 11 11 11 11 11 11 11 11 11 11 11 11 11 11 11 11 11 11 11 11 11 11 11 11 11 11 11 11 11 11 11 11 11 11 11 11 11 11 11 11 11 11 11 11 11 11 
11 11 11 11 11 11 11 11 11 11 11 11 11 11 11 11 11 11 11 11 11 11 11 11 11 11 11 11 11 11 11 11 11 11 11 11 11 11 11 11 11 11 11 11 11 11 11 11 11 11 
11 11 11 11 11 11 11 11 11 11 11 11 11 11 11 11 11 11 11 11 11 11 11 11 11 11 11 11 11 11 11 11 11 11 11 11 11 11 11 11 11 11 11 11 11 11 11 11 11 11  
11 11 11 11 11 11 11 11 11 11 11 11 11 11 11 11 11 11 11 11 11 11 11 11 11 11 11 11 11 11 11 11 11 11 11 11 11 11 11 11 11 11 11 11 11 11 11 11 11 11 
11 11 11 11 11 11 11 11 11 11 11 11 11 11 11 11 11 11 11 11 11 11 11 11 11 11 11 11 11 11 11 11 11 11 11 11 11 11 11 11 11 11 11 11 11 11 11 11 11 11 
11 11 11 11 11 11 11 11 11 11 11 11 11 11 11 11 11 11 11 11 11 11 11 11 11 11 11 11 11 11 11 11 11 11 11 11 11 11 11 11 11 11 11 11 11 11 11 11 11 11
11 11 11 11 11 11 11 4 4 4 4 4 4 4 4 4 4 4 4 7 7 7 7 7 6 6 6 6 6 5 5 5 5 5 5 5 5 5 5 5 11 11 11 11 11 11 11 11 11 11
11 11 11 11 11 11 11 4 7 7 7 4 7 7 4 7 7 4 4 7 7 7 7 7 6 6 6 6 6 6 5 5 5 5 5 5 5 5 5 5 5 5 11 11 11 11 11 11 11 11
11 11 11 11 11 11 11 4 7 4 4 4 7 4 4 7 4 7 4 7 7 7 7 7 6 6 6 6 6 6 6 6 6 5 5 5 5 5 5 5 5 5 5 11 11 11 11 11 11 11
11 11 11 11 11 11 11 4 7 7 7 4 7 7 4 7 7 4 4 7 7 7 7 7 6 6 6 6 6 6 6 6 6 6 6 6 6 6 6 6 10 10 10 11 11 11 11 11 11 11
11 11 11 11 11 11 11 4 4 4 7 4 7 4 4 7 4 7 4 7 7 7 7 7 6 6 6 6 6 6 6 6 6 6 6 6 6 6 6 6 10 10 10 11 11 11 11 11 11 11
11 11 11 11 11 11 11 4 7 7 7 4 7 7 4 7 7 4 4 7 7 7 7 7 6 6 6 6 6 6 10 10 10 10 10 6 6 6 6 6 10 10 10 11 11 11 11 11 11 11
11 11 11 11 11 11 11 4 4 4 4 4 4 4 4 4 4 4 4 7 7 7 7 7 6 6 6 6 6 6 10 10 11 10 10 6 6 6 6 6 10 10 10 11 11 11 11 11 11 11
11 11 11 11 11 11 11 7 7 7 7 7 7 7 10 7 7 7 7 7 7 7 7 7 6 6 6 6 6 6 10 11 11 11 10 6 6 6 6 6 10 10 10 11 11 11 11 11 11 11
11 11 11 11 11 11 11 7 7 7 7 7 7 10 10 10 10 10 10 10 10 10 10 10 6 6 6 6 6 6 10 10 11 10 10 6 6 6 6 6 10 10 10 11 11 11 11 11 11 11
11 11 11 11 11 11 11 7 7 7 7 7 7 10 10 10 10 10 10 10 10 10 10 10 6 6 6 6 6 6 10 10 10 10 10 6 6 6 6 6 10 10 10 11 11 11 11 11 11 11
11 11 11 11 11 11 11 7 7 7 7 7 7 10 10 10 10 10 10 10 10 10 10 10 6 6 6 6 6 6 10 10 10 6 6 6 6 6 6 10 10 10 10 11 11 11 11 11 11 11
11 11 11 11 11 11 11 7 7 6 7 7 7 10 10 10 10 10 10 10 10 10 10 10 6 6 6 6 6 6 10 6 6 6 6 6 6 10 10 10 10 10 10 11 11 11 11 11 11 11
11 11 11 11 11 11 11 7 7 7 7 6 7 10 10 10 10 10 10 10 10 10 10 10 10 10 10 10 10 10 10 6 6 6 6 6 10 10 6 6 10 10 10 11 11 11 11 11 11 11
11 11 11 11 11 11 11 7 7 7 7 6 7 10 10 10 10 10 10 10 10 10 10 10 10 10 10 10 10 10 6 6 6 6 6 10 10 6 6 6 6 7 7 11 11 11 11 11 11 11
11 11 11 11 11 11 11 7 6 6 7 7 7 10 10 10 10 10 10 10 10 10 10 10 10 10 10 10 10 10 10 10 10 10 10 10 10 6 6 7 7 7 7 11 11 11 11 11 11 11
11 11 11 11 11 11 11 7 6 6 7 7 7 7 7 10 10 10 7 7 7 7 7 7 6 6 6 6 6 6 6 6 6 6 6 6 6 6 6 7 6 6 6 11 11 11 11 11 11 11
11 11 11 11 11 11 11 1 1 1 1 1 1 7 7 10 10 10 7 7 7 7 7 7 6 6 6 6 7 7 7 6 7 7 7 7 7 7 7 7 7 7 6 11 11 11 11 11 11 11
11 11 11 11 11 11 11 1 1 1 1 1 1 7 7 10 10 10 7 7 7 7 7 7 6 6 7 7 7 6 7 7 7 6 6 7 6 6 6 6 6 7 6 11 11 11 11 11 11 11
11 11 11 11 11 11 11 1 1 1 1 1 1 7 7 10 10 10 7 7 7 7 7 7 6 6 7 6 6 6 6 6 7 6 6 7 6 6 6 6 6 6 6 11 11 11 11 11 11 11
11 11 11 11 11 11 11 1 1 1 1 1 1 7 7 10 10 10 7 7 7 7 7 7 6 6 7 6 6 6 6 6 7 6 6 7 7 7 7 6 7 7 6 11 11 11 11 11 11 11
11 11 11 11 11 11 11 1 1 1 1 1 1 7 7 10 10 10 6 6 7 6 6 7 6 6 7 6 6 7 7 7 7 6 6 7 6 6 7 7 7 6 6 11 11 11 11 11 11 11
11 11 11 11 11 11 11 7 10 10 10 7 7 7 7 10 10 10 7 6 7 6 7 7 6 6 7 6 6 6 6 6 7 7 7 7 6 6 6 6 6 7 6 11 11 11 11 11 11 11
11 11 11 11 11 11 11 7 10 10 10 7 7 7 7 10 10 10 7 7 6 7 7 7 6 7 7 7 7 6 6 6 7 6 6 7 6 6 7 7 7 7 6 11 11 11 11 11 11 11
11 11 11 11 11 11 11 7 10 10 10 7 7 7 7 10 10 10 6 7 7 7 6 7 6 7 6 6 7 6 6 6 7 6 6 7 7 7 7 6 7 6 6 11 11 11 11 11 11 11
11 11 11 11 11 11 11 7 10 10 10 7 7 7 10 10 10 7 7 6 6 6 7 7 6 7 6 6 6 6 6 7 7 6 6 6 7 7 6 6 7 6 6 11 11 11 11 11 11 11
11 11 11 11 11 11 11 7 10 10 10 7 7 7 10 10 10 7 7 7 7 7 7 7 6 7 6 6 7 7 7 7 6 6 6 6 6 6 6 6 7 6 6 11 11 11 11 11 11 11
11 11 11 11 11 11 11 7 10 10 10 7 7 7 10 10 10 7 7 7 7 7 7 7 6 7 7 7 6 6 6 6 6 6 7 7 7 7 7 7 7 6 6 11 11 11 11 11 11 11
11 11 11 11 11 11 11 10 10 10 10 10 10 10 10 10 10 10 10 10 7 7 7 7 6 6 6 7 6 6 2 2 2 2 2 2 2 2 2 2 2 2 2 11 11 11 11 11 11 11
11 11 11 11 11 11 11 10 10 10 10 10 10 10 10 10 10 10 10 10 7 7 7 7 6 6 6 7 6 6 2 0 1 1 0 0 0 1 0 1 0 0 2 11 11 11 11 11 11 11
11 11 11 11 11 11 11 10 10 10 10 10 10 10 10 10 10 10 10 10 10 7 7 7 7 7 6 7 6 6 2 1 1 0 1 1 1 0 1 0 1 0 2 11 11 11 11 11 11 11
11 11 11 11 11 11 11 10 10 10 10 10 10 10 10 10 10 10 10 10 10 10 10 10 7 7 6 7 6 6 2 0 0 0 1 0 0 0 1 1 0 1 2 11 11 11 11 11 11 11
11 11 11 11 11 11 11 10 10 10 10 10 10 10 10 10 10 10 10 10 10 10 10 10 7 7 6 7 7 6 2 0 1 1 1 0 1 1 0 0 0 1 2 11 11 11 11 11 11 11
11 11 11 11 11 11 11 10 10 10 10 10 10 10 10 10 10 10 10 10 10 10 10 10 7 7 6 6 7 7 7 0 0 0 1 0 0 0 1 1 0 1 2 11 11 11 11 11 11 11
11 11 11 11 11 11 11 10 10 10 10 10 10 10 10 10 10 10 10 10 10 10 7 7 7 7 7 6 6 6 2 1 1 1 1 1 1 0 1 0 1 0 2 11 11 11 11 11 11 11
11 11 11 11 11 11 11 10 10 10 10 10 10 10 10 10 10 10 10 10 10 10 7 7 7 7 7 7 7 7 2 0 0 0 1 0 0 0 1 1 0 1 2 11 11 11 11 11 11 11
11 11 11 11 11 11 11 10 10 10 10 10 10 10 10 10 10 10 10 10 7 7 7 7 7 7 7 7 7 7 2 2 2 2 2 2 2 2 2 2 2 2 2 11 11 11 11 11 11 11
11 11 11 11 11 11 11 11 11 11 11 11 11 11 11 11 11 11 11 11 11 11 11 11 11 11 11 11 11 11 11 11 11 11 11 11 11 11 11 11 11 11 11 11 11 11 11 11 11 11
11 11 11 11 11 11 11 11 11 11 11 11 11 11 11 11 11 11 11 11 11 11 11 11 11 11 11 11 11 11 11 11 11 11 11 11 11 11 11 11 11 11 11 11 11 11 11 11 11 11
11 11 11 11 11 11 11 11 11 11 11 11 11 11 11 11 11 11 11 11 11 11 11 11 11 11 11 11 11 11 11 11 11 11 11 11 11 11 11 11 11 11 11 11 11 11 11 11 11 11
11 11 11 11 11 11 11 11 11 11 11 11 11 11 11 11 11 11 11 11 11 11 11 11 11 11 11 11 11 11 11 11 11 11 11 11 11 11 11 11 11 11 11 11 11 11 11 11 11 11
11 11 11 11 11 11 11 11 11 11 11 11 11 11 11 11 11 11 11 11 11 11 11 11 11 11 11 11 11 11 11 11 11 11 11 11 11 11 11 11 11 11 11 11 11 11 11 11 11 11
11 11 11 11 11 11 11 11 11 11 11 11 11 11 11 11 11 11 11 11 11 11 11 11 11 11 11 11 11 11 11 11 11 11 11 11 11 11 11 11 11 11 11 11 11 11 11 11 11 11
11 11 11 11 11 11 11 11 11 11 11 11 11 11 11 11 11 11 11 11 11 11 11 11 11 11 11 11 11 11 11 11 11 11 11 11 11 11 11 11 11 11 11 11 11 11 11 11 11 11